R 640 480
NO ./images/NO.xpm
SO ./images/SO.xpm 
WE ./images/WE.xpm
EA ./images/EA.xpm
S ./images/ITEM.xpm
F 00,153,15
C 255,255,255

        1111111111111111111111111
        1000000000000000000000001
        1100000000000000000000001
        1000000111000000000000001
11111111100000000000011000000001
100000000020000000000000000001111
1000000020200000E0000000000001
10000000200200000000000000001
10000000000000000000000000001
100000000000000000000010000001
10000000000000000001010000001
11000001110101011111011110101
11110111 1110101 101111010001
11111111 1111111 111111111111
